//MAP CONVERTED BY dmm2tgm.py THIS HEADER COMMENT PREVENTS RECONVERSION, DO NOT REMOVE
"a" = (
/obj/effect/decal/warning_stripes{
	icon_state = "E";
	dir = 1
	},
/turf/open/shuttle/lifeboat,
/area/shuttle/sulaco/elevator_cen1/elevator)
"d" = (
/turf/closed/shuttle/elevator{
	dir = 5
	},
/area/shuttle/sulaco/elevator_cen1/elevator)
"f" = (
/turf/closed/shuttle/elevator{
	dir = 9
	},
/area/shuttle/sulaco/elevator_cen1/elevator)
"h" = (
/obj/structure/shuttle/window{
	indestructible = 1
	},
/turf/open/shuttle/lifeboat,
/area/shuttle/sulaco/elevator_cen1/elevator)
"j" = (
/turf/closed/shuttle/elevator,
/area/shuttle/sulaco/elevator_cen1/elevator)
"o" = (
/obj/effect/decal/warning_stripes{
	icon_state = "NE-out";
	pixel_x = 2
	},
/turf/open/shuttle/lifeboat,
/area/shuttle/sulaco/elevator_cen1/elevator)
"r" = (
/turf/closed/wall/r_wall/elevator/arrivals,
/area/shuttle/sulaco/elevator_cen1/elevator)
"s" = (
/turf/open/shuttle/elevator/grating,
/area/shuttle/sulaco/elevator_cen1/elevator)
"w" = (
/turf/closed/shuttle/elevator{
	dir = 4
	},
/area/shuttle/sulaco/elevator_cen1/elevator)
"C" = (
/turf/closed/shuttle/elevator{
	dir = 8
	},
/area/shuttle/sulaco/elevator_cen1/elevator)
"D" = (
/obj/effect/decal/warning_stripes{
	icon_state = "SE-out";
	pixel_x = 2
	},
/obj/structure/machinery/power/apc{
	dir = 4
	},
/turf/open/shuttle/lifeboat,
/area/shuttle/sulaco/elevator_cen1/elevator)
"J" = (
/turf/closed/shuttle/elevator{
	dir = 6
	},
/area/shuttle/sulaco/elevator_cen1/elevator)
"L" = (
/obj/structure/sign/safety/one,
/turf/closed/shuttle/elevator,
/area/shuttle/sulaco/elevator_cen1/elevator)
"Q" = (
/obj/structure/machinery/door/poddoor/almayer/locked{
	dir = 4;
	id = "east"
	},
/turf/open/shuttle/lifeboat,
/area/shuttle/sulaco/elevator_cen1/elevator)
"R" = (
/obj/docking_port/mobile/sulaco/elevator1,
/turf/closed/shuttle/elevator{
	dir = 10
	},
/area/shuttle/sulaco/elevator_cen1/elevator)
"S" = (
/obj/structure/machinery/computer/shuttle/elevator_controller/elevator_call/sulaco{
	shuttleId = "sulacocen1"
	},
/turf/closed/shuttle/elevator/button/arrivals,
/area/shuttle/sulaco/elevator_cen1/elevator)
"T" = (
/turf/open/shuttle/lifeboat,
/area/shuttle/sulaco/elevator_cen1/elevator)
"W" = (
/turf/closed/wall/r_wall/elevator/gears,
/area/shuttle/sulaco/elevator_cen1/elevator)

(1,1,1) = {"
f
j
h
h
j
R
"}
(2,1,1) = {"
C
T
T
T
T
W
"}
(3,1,1) = {"
w
T
s
s
T
w
"}
(4,1,1) = {"
C
T
T
T
T
w
"}
(5,1,1) = {"
S
T
s
s
T
w
"}
(6,1,1) = {"
r
D
a
a
o
W
"}
(7,1,1) = {"
d
j
Q
Q
L
J
"}
